111111111
1000P1101
101100CC1
1111111E1
111111111